//MAP CONVERTED BY dmm2tgm.py THIS HEADER COMMENT PREVENTS RECONVERSION, DO NOT REMOVE
"bt" = (
/turf/open/floor/plating/ashplanet/rocky,
/area/lavaland/surface/outdoors)
"bz" = (
/obj/structure/spider/stickyweb,
/turf/open/floor/plating/ashplanet/rocky,
/area/lavaland/surface/outdoors)
"cz" = (
/turf/open/lava/smooth,
/area/lavaland/surface/outdoors)
"da" = (
/obj/structure/railing{
	dir = 9
	},
/obj/structure/stone_tile{
	dir = 8
	},
/obj/structure/stone_tile{
	dir = 1
	},
/obj/structure/stone_tile/surrounding_tile,
/turf/open/floor/plating/ashplanet/rocky,
/area/lavaland/surface/outdoors)
"es" = (
/obj/effect/decal/cleanable/dirt/dust,
/turf/open/floor/stone,
/area/lavaland/surface/outdoors)
"ev" = (
/obj/effect/decal/cleanable/dirt/dust,
/turf/open/floor/plating/ashplanet/rocky,
/area/lavaland/surface/outdoors)
"fB" = (
/obj/structure/railing,
/obj/structure/stone_tile/block/cracked{
	dir = 1
	},
/turf/open/floor/plating/ashplanet/rocky,
/area/lavaland/surface/outdoors)
"fJ" = (
/obj/structure/railing{
	dir = 8
	},
/obj/effect/decal/cleanable/ash{
	pixel_y = -1;
	pixel_x = 12
	},
/obj/effect/decal/cleanable/dirt,
/obj/structure/stone_tile/block{
	dir = 4
	},
/turf/open/floor/stone,
/area/lavaland/surface/outdoors)
"fX" = (
/obj/structure/table/wood,
/turf/open/floor/stone,
/area/lavaland/surface/outdoors)
"gp" = (
/obj/structure/railing/corner{
	dir = 8
	},
/obj/structure/railing/corner,
/turf/open/floor/vault,
/area/lavaland/surface/outdoors)
"hv" = (
/obj/structure/railing,
/obj/effect/decal/cleanable/ash/large{
	pixel_y = 11;
	pixel_x = 18
	},
/obj/structure/stone_tile/block{
	dir = 1
	},
/turf/open/floor/plating/ashplanet/rocky,
/area/lavaland/surface/outdoors)
"hG" = (
/obj/structure/table/wood,
/obj/item/stack/ore/iron{
	pixel_y = 7;
	pixel_x = -8
	},
/obj/item/stack/ore/uranium{
	pixel_y = 6;
	pixel_x = 3
	},
/obj/item/stack/ore/titanium{
	pixel_y = 10;
	pixel_x = -2
	},
/obj/item/stack/ore/gold{
	pixel_y = 14
	},
/obj/item/stack/ore/silver,
/obj/structure/stone_tile/slab/cracked,
/turf/open/floor/plating/ashplanet/rocky,
/area/lavaland/surface/outdoors)
"hP" = (
/turf/open/floor/grass/snow,
/area/lavaland/surface/outdoors)
"ik" = (
/obj/structure/spider/stickyweb,
/obj/effect/decal/cleanable/blood/old,
/turf/open/floor/stone,
/area/lavaland/surface/outdoors)
"iw" = (
/obj/effect/decal/cleanable/dirt,
/obj/structure/spider/stickyweb,
/mob/living/simple_animal/hostile/poison/giant_spider,
/turf/open/floor/stone,
/area/lavaland/surface/outdoors)
"iA" = (
/obj/effect/decal/cleanable/dirt,
/turf/open/floor/plating/ashplanet/rocky,
/area/lavaland/surface/outdoors)
"iC" = (
/obj/effect/decal/cleanable/dirt,
/obj/structure/spider/stickyweb,
/turf/open/floor/stone,
/area/lavaland/surface/outdoors)
"jF" = (
/obj/machinery/mineral/mint,
/obj/structure/stone_tile/slab/cracked,
/turf/open/floor/stone,
/area/lavaland/surface/outdoors)
"lP" = (
/obj/structure/railing{
	dir = 4
	},
/obj/structure/railing{
	dir = 8
	},
/turf/open/floor/vault,
/area/lavaland/surface/outdoors)
"mE" = (
/obj/structure/railing/corner{
	dir = 4
	},
/obj/structure/railing/corner{
	dir = 1
	},
/turf/open/floor/vault,
/area/lavaland/surface/outdoors)
"mI" = (
/obj/effect/decal/cleanable/blood/old,
/turf/open/floor/stone,
/area/lavaland/surface/outdoors)
"nj" = (
/obj/structure/railing{
	dir = 1
	},
/obj/structure/ore_box,
/obj/effect/decal/cleanable/dirt,
/obj/structure/stone_tile/block/cracked,
/turf/open/floor/plating/ashplanet/rocky,
/area/lavaland/surface/outdoors)
"nW" = (
/obj/item/stack/sheet/mineral/wood,
/obj/effect/decal/cleanable/ash,
/obj/effect/decal/cleanable/dirt/dust,
/mob/living/simple_animal/hostile/poison/giant_spider,
/turf/open/floor/plating/ashplanet/rocky,
/area/lavaland/surface/outdoors)
"ob" = (
/turf/open/floor/stone,
/area/lavaland/surface/outdoors)
"oi" = (
/obj/structure/table/wood,
/obj/item/gavelhammer{
	name = "hammer";
	desc = "A hammer used by a blacksmith."
	},
/obj/item/stack/cable_coil/red{
	pixel_y = 18
	},
/obj/effect/decal/cleanable/dirt,
/turf/open/floor/stone,
/area/lavaland/surface/outdoors)
"pp" = (
/obj/structure/railing{
	dir = 4
	},
/obj/effect/decal/cleanable/dirt,
/obj/structure/stone_tile/block/cracked{
	dir = 8
	},
/turf/open/floor/stone,
/area/lavaland/surface/outdoors)
"pI" = (
/obj/structure/railing,
/obj/structure/stone_tile/block{
	dir = 1
	},
/turf/open/floor/plating/ashplanet/rocky,
/area/lavaland/surface/outdoors)
"qG" = (
/obj/structure/railing{
	dir = 1
	},
/obj/structure/stone_tile/block/burnt,
/turf/open/floor/plating/ashplanet/rocky,
/area/lavaland/surface/outdoors)
"rR" = (
/obj/effect/decal/remains/human,
/turf/open/floor/stone,
/area/lavaland/surface/outdoors)
"rS" = (
/mob/living/simple_animal/hostile/poison/giant_spider,
/turf/open/floor/plating/ashplanet/rocky,
/area/lavaland/surface/outdoors)
"rT" = (
/obj/structure/railing{
	dir = 8
	},
/obj/effect/decal/cleanable/dirt,
/obj/effect/decal/remains/human,
/obj/structure/stone_tile/block/burnt{
	dir = 4
	},
/turf/open/floor/plating/ashplanet/rocky,
/area/lavaland/surface/outdoors)
"sF" = (
/obj/structure/table/wood,
/obj/item/stack/sheet/iron{
	pixel_x = -9;
	pixel_y = 4
	},
/obj/item/stack/sheet/mineral/bananium/five,
/turf/open/floor/stone,
/area/lavaland/surface/outdoors)
"vC" = (
/obj/structure/railing{
	dir = 1
	},
/obj/structure/stone_tile/block,
/turf/open/floor/plating/ashplanet/rocky,
/area/lavaland/surface/outdoors)
"wO" = (
/obj/structure/table/wood,
/obj/item/stack/sheet/mineral/titanium/five{
	pixel_y = 4;
	pixel_x = -4
	},
/turf/open/floor/stone,
/area/lavaland/surface/outdoors)
"xz" = (
/obj/structure/pool_ladder,
/turf/open/lava/smooth,
/area/lavaland/surface/outdoors)
"xK" = (
/obj/structure/spider/stickyweb,
/turf/open/floor/stone,
/area/lavaland/surface/outdoors)
"yC" = (
/obj/structure/mineral_door/iron,
/obj/effect/decal/cleanable/dirt/dust,
/obj/structure/spider/stickyweb,
/turf/open/floor/grass/snow,
/area/lavaland/surface/outdoors)
"zt" = (
/obj/effect/decal/cleanable/ash,
/obj/structure/stone_tile{
	dir = 4
	},
/obj/structure/stone_tile{
	dir = 1
	},
/obj/structure/stone_tile{
	dir = 8
	},
/obj/structure/railing{
	dir = 4
	},
/turf/open/floor/plating/ashplanet/rocky,
/area/lavaland/surface/outdoors)
"AE" = (
/obj/structure/railing,
/obj/effect/decal/cleanable/dirt/dust,
/obj/structure/stone_tile/block/burnt{
	dir = 1
	},
/turf/open/floor/plating/ashplanet/rocky,
/area/lavaland/surface/outdoors)
"Bp" = (
/mob/living/simple_animal/hostile/poison/giant_spider,
/turf/open/floor/stone,
/area/lavaland/surface/outdoors)
"BT" = (
/obj/structure/railing,
/obj/effect/decal/cleanable/ash,
/obj/structure/stone_tile/block{
	dir = 1
	},
/turf/open/floor/stone,
/area/lavaland/surface/outdoors)
"CX" = (
/obj/structure/table/wood,
/obj/item/wirebrush,
/turf/open/floor/stone,
/area/lavaland/surface/outdoors)
"Dm" = (
/obj/structure/railing{
	dir = 5
	},
/mob/living/simple_animal/hostile/poison/giant_spider,
/obj/structure/stone_tile/block{
	dir = 8
	},
/obj/structure/stone_tile/block,
/turf/open/floor/plating/ashplanet/rocky,
/area/lavaland/surface/outdoors)
"Eb" = (
/obj/structure/table/wood,
/obj/item/stack/ore/slag,
/turf/open/floor/plating/ashplanet/rocky,
/area/lavaland/surface/outdoors)
"FB" = (
/obj/structure/mineral_door/iron,
/turf/open/floor/grass/snow,
/area/lavaland/surface/outdoors)
"Gd" = (
/obj/structure/mineral_door/iron,
/turf/open/floor/stone,
/area/lavaland/surface/outdoors)
"GR" = (
/obj/effect/decal/cleanable/dirt,
/obj/structure/spider/stickyweb,
/turf/open/floor/plating/ashplanet/rocky,
/area/lavaland/surface/outdoors)
"HO" = (
/obj/structure/table/wood,
/obj/structure/spider/stickyweb,
/turf/open/floor/stone,
/area/lavaland/surface/outdoors)
"HP" = (
/obj/structure/railing{
	dir = 10
	},
/obj/structure/stone_tile{
	dir = 4
	},
/obj/structure/stone_tile{
	dir = 1
	},
/obj/structure/stone_tile,
/turf/open/floor/plating/ashplanet/rocky,
/area/lavaland/surface/outdoors)
"IQ" = (
/obj/effect/decal/cleanable/cobweb,
/obj/effect/decal/cleanable/dirt,
/turf/open/floor/stone,
/area/lavaland/surface/outdoors)
"JE" = (
/turf/closed/wall/mineral/iron,
/area/lavaland/surface/outdoors)
"JH" = (
/obj/structure/table/wood,
/obj/structure/spider/stickyweb,
/obj/item/stack/sheet/mineral/uranium/twenty{
	pixel_y = -3;
	pixel_x = -11
	},
/turf/open/floor/stone,
/area/lavaland/surface/outdoors)
"JU" = (
/obj/structure/stone_tile/center{
	pixel_y = 2;
	pixel_x = -15
	},
/obj/structure/stone_tile/center{
	pixel_y = -14;
	pixel_x = 14
	},
/obj/structure/stone_tile/cracked{
	pixel_x = 4;
	pixel_y = 5
	},
/obj/structure/frame{
	icon = 'icons/obj/cult.dmi';
	icon_state = "forge";
	name = "furnace";
	desc = "An ancient, rusty furnace. Commonly used by blacksmiths, however this one is beyond repair."
	},
/turf/open/floor/plasteel/cult,
/area/lavaland/surface/outdoors)
"Ka" = (
/obj/effect/decal/cleanable/dirt,
/mob/living/simple_animal/hostile/poison/giant_spider,
/obj/effect/decal/cleanable/blood/old,
/turf/open/floor/stone,
/area/lavaland/surface/outdoors)
"KJ" = (
/obj/structure/railing{
	dir = 1
	},
/obj/effect/decal/cleanable/dirt/dust,
/obj/structure/stone_tile/block/burnt,
/turf/open/floor/plating/ashplanet/rocky,
/area/lavaland/surface/outdoors)
"KL" = (
/obj/effect/decal/cleanable/ash/large{
	pixel_y = 11;
	pixel_x = 18
	},
/obj/structure/spider/stickyweb,
/mob/living/simple_animal/hostile/poison/giant_spider,
/turf/open/floor/plating/ashplanet/rocky,
/area/lavaland/surface/outdoors)
"Ow" = (
/obj/structure/table/wood,
/obj/item/stack/sheet/iron{
	pixel_x = -9;
	pixel_y = 4
	},
/turf/open/floor/stone,
/area/lavaland/surface/outdoors)
"Pp" = (
/obj/structure/ore_box,
/turf/open/floor/stone,
/area/lavaland/surface/outdoors)
"PR" = (
/turf/closed/mineral/snowmountain/cavern,
/area/lavaland/surface/outdoors)
"SW" = (
/obj/structure/railing{
	dir = 1
	},
/obj/structure/ore_box,
/obj/structure/spider/stickyweb,
/obj/structure/stone_tile/block,
/turf/open/floor/stone,
/area/lavaland/surface/outdoors)
"TU" = (
/obj/effect/decal/remains/human,
/obj/item/chair/wood,
/turf/open/floor/plating/ashplanet/rocky,
/area/lavaland/surface/outdoors)
"Ud" = (
/obj/structure/railing/corner{
	dir = 4
	},
/obj/structure/stone_tile{
	dir = 8
	},
/turf/open/floor/plating/ashplanet/rocky,
/area/lavaland/surface/outdoors)
"UK" = (
/obj/structure/railing/corner{
	dir = 8
	},
/obj/structure/spider/stickyweb,
/obj/structure/stone_tile{
	dir = 1
	},
/turf/open/floor/plating/ashplanet/rocky,
/area/lavaland/surface/outdoors)
"Vd" = (
/obj/structure/table/wood,
/obj/item/stack/sheet/mineral/silver/five{
	pixel_y = 5;
	pixel_x = 7
	},
/turf/open/floor/stone,
/area/lavaland/surface/outdoors)
"VF" = (
/obj/structure/railing{
	dir = 4
	},
/obj/effect/decal/cleanable/ash,
/obj/structure/stone_tile/block{
	dir = 8
	},
/turf/open/floor/plating/ashplanet/rocky,
/area/lavaland/surface/outdoors)
"Wf" = (
/obj/structure/table/wood,
/obj/effect/decal/cleanable/dirt,
/obj/item/stack/sheet/mineral/copper/fifty{
	pixel_y = 5;
	pixel_x = -4
	},
/obj/item/stack/sheet/mineral/gold/five{
	pixel_y = -1;
	pixel_x = 4
	},
/turf/open/floor/stone,
/area/lavaland/surface/outdoors)
"WZ" = (
/obj/structure/railing{
	dir = 1
	},
/obj/structure/ore_box,
/obj/structure/stone_tile/block/burnt,
/turf/open/floor/plating/ashplanet/rocky,
/area/lavaland/surface/outdoors)
"Xl" = (
/obj/structure/table/wood,
/obj/effect/decal/cleanable/cobweb,
/obj/item/stack/sheet/glass/fifty,
/turf/open/floor/stone,
/area/lavaland/surface/outdoors)
"Xw" = (
/obj/structure/table/wood,
/obj/effect/decal/cleanable/cobweb/cobweb2,
/obj/item/stack/sheet/mineral/plasma/twenty,
/turf/open/floor/stone,
/area/lavaland/surface/outdoors)
"XK" = (
/obj/structure/railing{
	dir = 4
	},
/obj/effect/decal/cleanable/dirt,
/obj/effect/decal/remains/human,
/obj/structure/stone_tile/block{
	dir = 8
	},
/turf/open/floor/plating/ashplanet/rocky,
/area/lavaland/surface/outdoors)
"YB" = (
/obj/structure/railing{
	dir = 8
	},
/obj/structure/stone_tile/block/cracked{
	dir = 4
	},
/turf/open/floor/plating/ashplanet/rocky,
/area/lavaland/surface/outdoors)

(1,1,1) = {"
JE
JE
JE
JE
JE
JE
PR
PR
PR
PR
PR
PR
PR
PR
PR
PR
"}
(2,1,1) = {"
JE
Xl
Ow
iw
Vd
JE
PR
PR
PR
PR
PR
PR
PR
PR
PR
PR
"}
(3,1,1) = {"
JE
jF
mI
mI
wO
JE
PR
PR
PR
PR
PR
PR
PR
PR
PR
PR
"}
(4,1,1) = {"
JE
HO
ob
xK
JH
JE
JE
JE
JE
JE
JE
JE
JE
JE
JE
PR
"}
(5,1,1) = {"
JE
Wf
Bp
rR
Ka
Gd
IQ
BT
cz
cz
cz
cz
cz
cz
JE
PR
"}
(6,1,1) = {"
JE
Xw
ik
ob
HO
JE
rS
AE
cz
da
HP
cz
cz
cz
JE
PR
"}
(7,1,1) = {"
JE
JE
JE
Gd
JE
JE
hG
hv
cz
WZ
UK
YB
rT
fJ
JE
JE
"}
(8,1,1) = {"
PR
PR
JE
xK
bt
GR
ev
fB
cz
vC
bt
ev
KL
es
yC
hP
"}
(9,1,1) = {"
PR
PR
JE
pp
VF
Ud
bt
gp
lP
mE
ev
bt
bt
ob
FB
hP
"}
(10,1,1) = {"
PR
PR
JE
cz
cz
KJ
JU
pI
cz
qG
bz
iA
bt
iC
JE
JE
"}
(11,1,1) = {"
PR
PR
JE
cz
cz
Dm
XK
zt
xz
nj
nW
Eb
TU
CX
JE
PR
"}
(12,1,1) = {"
PR
PR
JE
cz
cz
cz
cz
cz
cz
SW
Pp
sF
oi
fX
JE
PR
"}
(13,1,1) = {"
PR
PR
JE
JE
JE
JE
JE
JE
JE
JE
JE
JE
JE
JE
JE
PR
"}
