//MAP CONVERTED BY dmm2tgm.py THIS HEADER COMMENT PREVENTS RECONVERSION, DO NOT REMOVE
"aV" = (
/obj/effect/turf_decal/stripes/closeup,
/turf/open/floor/mineral/plastitanium/red,
/area/space)
"fw" = (
/obj/effect/turf_decal/stripes/line{
	dir = 6
	},
/obj/effect/turf_decal/tile/neutral/tile_full,
/obj/structure/chair/comfy/black{
	dir = 1
	},
/turf/open/floor/pod/dark,
/area/space)
"fG" = (
/obj/effect/turf_decal/trimline/brown/filled/line{
	dir = 8
	},
/obj/effect/turf_decal/trimline/brown/filled/line{
	dir = 8
	},
/obj/effect/turf_decal/trimline/brown/filled/line{
	dir = 8
	},
/obj/effect/turf_decal/tile/neutral/tile_side,
/obj/machinery/light{
	dir = 8
	},
/obj/machinery/button/door{
	id = "syndiecargo_entranceshutters";
	name = "cargohold shutters";
	pixel_x = -28
	},
/turf/open/floor/plasteel/techmaint,
/area/space)
"gr" = (
/obj/effect/turf_decal/trimline/brown/filled/corner{
	dir = 1
	},
/obj/effect/turf_decal/trimline/brown/filled/corner{
	dir = 1
	},
/obj/effect/turf_decal/trimline/brown/filled/corner{
	dir = 1
	},
/obj/effect/turf_decal/tile/neutral/tile_side{
	dir = 9
	},
/obj/effect/decal/cleanable/dirt,
/obj/effect/decal/cleanable/generic,
/turf/open/floor/plasteel/techmaint,
/area/space)
"gG" = (
/obj/effect/turf_decal/stripes/line{
	dir = 6
	},
/obj/effect/turf_decal/tile/neutral{
	dir = 1
	},
/obj/structure/table/reinforced,
/obj/item/paper_bin{
	pixel_x = -4;
	pixel_y = 4
	},
/obj/item/pen,
/turf/open/floor/plasteel/techmaint,
/area/space)
"he" = (
/obj/effect/turf_decal/trimline/brown/filled/line,
/obj/effect/turf_decal/trimline/brown/filled/line,
/obj/effect/turf_decal/trimline/brown/filled/line,
/obj/effect/turf_decal/tile/neutral/tile_side{
	dir = 4
	},
/obj/effect/decal/cleanable/dirt/dust,
/turf/open/floor/plasteel/techmaint,
/area/space)
"hh" = (
/obj/effect/turf_decal/tile/neutral/tile_full,
/obj/effect/turf_decal/box,
/obj/effect/turf_decal/arrows{
	dir = 4;
	icon_state = "arrows"
	},
/obj/effect/decal/cleanable/dirt/dust,
/obj/effect/decal/cleanable/dirt/dust,
/obj/structure/closet/crate,
/turf/open/floor/plasteel/techmaint,
/area/space)
"hS" = (
/obj/effect/turf_decal/stripes/closeup{
	dir = 1
	},
/obj/machinery/door/airlock/hatch,
/obj/machinery/door/firedoor,
/turf/open/floor/plasteel/techmaint,
/area/space)
"hZ" = (
/obj/structure/closet/crate,
/obj/item/stack/sheet/iron/twenty,
/obj/item/stack/sheet/glass{
	amount = 10
	},
/obj/item/stack/sheet/mineral/plastitanium{
	amount = 20
	},
/obj/item/storage/box/lights/bulbs,
/obj/item/storage/toolbox/mechanical,
/obj/item/stack/sheet/mineral/plasma{
	amount = 20
	},
/obj/effect/turf_decal/stripes/line{
	dir = 10
	},
/obj/effect/turf_decal/tile/neutral{
	dir = 4
	},
/obj/machinery/light,
/turf/open/floor/plasteel/techmaint,
/area/space)
"iL" = (
/turf/open/floor/mineral/plastitanium,
/area/space)
"iQ" = (
/obj/effect/turf_decal/trimline/brown/filled/warning{
	dir = 8
	},
/obj/effect/turf_decal/trimline/brown/filled/warning{
	dir = 8
	},
/obj/effect/turf_decal/trimline/brown/filled/warning{
	dir = 8
	},
/obj/effect/turf_decal/tile/neutral/tile_side,
/obj/effect/turf_decal/loading_area{
	dir = 8
	},
/turf/open/floor/plasteel/techmaint,
/area/space)
"jg" = (
/obj/machinery/porta_turret/syndicate/pod{
	dir = 6
	},
/turf/closed/wall/r_wall/syndicate,
/area/space)
"jr" = (
/obj/machinery/porta_turret/syndicate/pod{
	dir = 10
	},
/turf/closed/wall/r_wall/syndicate,
/area/space)
"kC" = (
/obj/machinery/porta_turret/syndicate/pod{
	dir = 5
	},
/turf/closed/wall/r_wall/syndicate,
/area/space)
"kD" = (
/obj/effect/turf_decal/stripes/line{
	dir = 10
	},
/obj/effect/turf_decal/tile/neutral{
	dir = 4
	},
/obj/structure/rack,
/obj/item/pickaxe/mini,
/obj/item/flashlight/seclite,
/obj/item/extinguisher/mini,
/obj/effect/turf_decal/bot,
/obj/item/tank/internals/oxygen/yellow,
/turf/open/floor/plasteel/techmaint,
/area/space)
"kW" = (
/obj/effect/turf_decal/stripes/line,
/obj/effect/turf_decal/tile/neutral/tile_side{
	dir = 4
	},
/obj/machinery/power/smes{
	charge = 5e+006
	},
/turf/open/floor/plasteel/techmaint,
/area/space)
"mg" = (
/turf/open/floor/plating,
/area/space)
"mG" = (
/obj/machinery/porta_turret/syndicate/pod{
	dir = 8
	},
/turf/closed/wall/r_wall/syndicate,
/area/space)
"mS" = (
/obj/effect/turf_decal/trimline/brown/filled/line{
	dir = 6
	},
/obj/effect/turf_decal/trimline/brown/filled/line{
	dir = 6
	},
/obj/effect/turf_decal/trimline/brown/filled/line{
	dir = 6
	},
/obj/effect/turf_decal/tile/neutral{
	dir = 1
	},
/turf/open/floor/plasteel/techmaint,
/area/space)
"nO" = (
/turf/open/floor/mineral/plastitanium/red,
/area/space)
"ok" = (
/obj/effect/turf_decal/tile/neutral/tile_full,
/obj/structure/cable{
	icon_state = "1-2"
	},
/turf/open/floor/plasteel/techmaint,
/area/space)
"oL" = (
/obj/machinery/porta_turret/syndicate/pod{
	dir = 9
	},
/turf/closed/wall/r_wall/syndicate,
/area/space)
"qy" = (
/obj/effect/turf_decal/bot_white,
/turf/open/floor/mineral/plastitanium,
/area/space)
"qV" = (
/obj/effect/turf_decal/stripes/line{
	dir = 8
	},
/obj/effect/turf_decal/stripes/line{
	dir = 4
	},
/turf/open/floor/mineral/plastitanium/red,
/area/space)
"rt" = (
/obj/effect/turf_decal/tile/neutral/tile_full,
/obj/effect/turf_decal/box,
/obj/effect/turf_decal/arrows{
	dir = 4;
	icon_state = "arrows"
	},
/obj/effect/decal/cleanable/dirt,
/turf/open/floor/plasteel/techmaint,
/area/space)
"rU" = (
/obj/effect/turf_decal/stripes/line{
	dir = 6
	},
/obj/effect/turf_decal/tile/neutral{
	dir = 1
	},
/obj/structure/table/reinforced,
/obj/item/stock_parts/cell/high/plus,
/obj/machinery/cell_charger,
/obj/item/stock_parts/cell/high/plus{
	pixel_x = 4;
	pixel_y = 4
	},
/obj/item/multitool,
/obj/machinery/light,
/turf/open/floor/plasteel/techmaint,
/area/space)
"sb" = (
/obj/effect/turf_decal/trimline/brown/filled/line{
	dir = 4
	},
/obj/effect/turf_decal/trimline/brown/filled/line{
	dir = 4
	},
/obj/effect/turf_decal/trimline/brown/filled/line{
	dir = 4
	},
/obj/effect/turf_decal/tile/neutral/tile_side{
	dir = 1
	},
/obj/effect/decal/cleanable/dirt/dust,
/obj/machinery/light{
	dir = 4
	},
/turf/open/floor/plasteel/techmaint,
/area/space)
"sq" = (
/obj/effect/turf_decal/stripes/line{
	dir = 1
	},
/obj/effect/turf_decal/tile/neutral/tile_side{
	dir = 8
	},
/obj/structure/tank_dispenser/oxygen,
/obj/effect/turf_decal/bot,
/turf/open/floor/plasteel/techmaint,
/area/space)
"sJ" = (
/obj/effect/turf_decal/trimline/brown/filled/line,
/obj/effect/turf_decal/trimline/brown/filled/line,
/obj/effect/turf_decal/trimline/brown/filled/line,
/obj/effect/turf_decal/tile/neutral/tile_side{
	dir = 4
	},
/turf/open/floor/plasteel/techmaint,
/area/space)
"sY" = (
/obj/effect/turf_decal/tile/neutral/tile_full,
/obj/effect/decal/cleanable/dirt,
/obj/effect/decal/cleanable/dirt/dust,
/turf/open/floor/plasteel/techmaint,
/area/space)
"tk" = (
/obj/effect/turf_decal/trimline/brown/filled/warning{
	dir = 4
	},
/obj/effect/turf_decal/trimline/brown/filled/warning{
	dir = 4
	},
/obj/effect/turf_decal/trimline/brown/filled/warning{
	dir = 4
	},
/obj/effect/turf_decal/tile/neutral/tile_side{
	dir = 1
	},
/obj/effect/turf_decal/loading_area{
	dir = 4
	},
/obj/effect/decal/cleanable/dirt,
/obj/effect/decal/cleanable/dirt/dust,
/turf/open/floor/plasteel/techmaint,
/area/space)
"tJ" = (
/obj/effect/turf_decal/trimline/brown/filled/warning{
	dir = 4
	},
/obj/effect/turf_decal/trimline/brown/filled/warning{
	dir = 4
	},
/obj/effect/turf_decal/trimline/brown/filled/warning{
	dir = 4
	},
/obj/effect/turf_decal/tile/neutral/tile_side{
	dir = 1
	},
/obj/effect/turf_decal/loading_area{
	dir = 4
	},
/turf/open/floor/plasteel/techmaint,
/area/space)
"uR" = (
/obj/effect/turf_decal/trimline/brown/filled/warning{
	dir = 8
	},
/obj/effect/turf_decal/trimline/brown/filled/warning{
	dir = 8
	},
/obj/effect/turf_decal/trimline/brown/filled/warning{
	dir = 8
	},
/obj/effect/turf_decal/tile/neutral/tile_side,
/obj/effect/turf_decal/loading_area{
	dir = 8
	},
/obj/effect/decal/cleanable/dirt,
/turf/open/floor/plasteel/techmaint,
/area/space)
"vx" = (
/obj/effect/turf_decal/stripes/line{
	dir = 5
	},
/obj/effect/turf_decal/tile/neutral{
	dir = 8
	},
/obj/effect/decal/cleanable/robot_debris,
/obj/structure/table/reinforced,
/obj/item/storage/toolbox/syndicate{
	pixel_y = 8
	},
/obj/item/assembly/voice,
/obj/item/assembly/signaler{
	desc = "Used to remotely activate devices. Allows for syncing when using a secure signaler on another. Slightly scooted.";
	pixel_x = 4;
	pixel_y = 4
	},
/obj/item/assembly/igniter,
/obj/machinery/light{
	dir = 4
	},
/turf/open/floor/plasteel/techmaint,
/area/space)
"wj" = (
/obj/effect/turf_decal/stripes/corner{
	dir = 9
	},
/obj/effect/turf_decal/tile/neutral/tile_side{
	dir = 8
	},
/turf/open/floor/plasteel/techmaint,
/area/space)
"wC" = (
/obj/effect/turf_decal/stripes/line,
/obj/effect/turf_decal/tile/neutral/tile_side{
	dir = 4
	},
/obj/structure/reagent_dispensers/fueltank,
/obj/effect/turf_decal/delivery,
/turf/open/floor/plasteel/techmaint,
/area/space)
"wQ" = (
/obj/effect/turf_decal/stripes/line,
/obj/effect/turf_decal/tile/neutral/tile_side{
	dir = 4
	},
/obj/machinery/power/port_gen/pacman{
	anchored = 1
	},
/obj/effect/turf_decal/bot,
/obj/structure/cable,
/turf/open/floor/plasteel/techmaint,
/area/space)
"xs" = (
/obj/effect/turf_decal/trimline/brown/filled/line{
	dir = 1
	},
/obj/effect/turf_decal/trimline/brown/filled/line{
	dir = 1
	},
/obj/effect/turf_decal/trimline/brown/filled/line{
	dir = 1
	},
/obj/effect/turf_decal/tile/neutral/tile_side{
	dir = 8
	},
/obj/effect/decal/cleanable/dirt,
/obj/machinery/light{
	dir = 1
	},
/turf/open/floor/plasteel/techmaint,
/area/space)
"yx" = (
/obj/effect/turf_decal/stripes/line{
	dir = 1
	},
/obj/effect/turf_decal/stripes/corner{
	dir = 10
	},
/turf/open/floor/mineral/plastitanium/red,
/area/space)
"zr" = (
/obj/effect/turf_decal/trimline/brown/filled/line{
	dir = 5
	},
/obj/effect/turf_decal/trimline/brown/filled/line{
	dir = 5
	},
/obj/effect/turf_decal/trimline/brown/filled/line{
	dir = 5
	},
/obj/effect/turf_decal/tile/neutral{
	dir = 8
	},
/turf/open/floor/plasteel/techmaint,
/area/space)
"Al" = (
/obj/effect/turf_decal/stripes/line{
	dir = 5
	},
/obj/effect/turf_decal/tile/neutral/tile_full,
/obj/machinery/computer/secure_data/syndie,
/turf/open/floor/mineral/plastitanium,
/area/space)
"AR" = (
/obj/effect/turf_decal/trimline/brown/filled/warning{
	dir = 1
	},
/obj/effect/turf_decal/trimline/brown/filled/warning{
	dir = 1
	},
/obj/effect/turf_decal/trimline/brown/filled/warning{
	dir = 1
	},
/obj/effect/turf_decal/tile/neutral/tile_side{
	dir = 8
	},
/obj/effect/decal/cleanable/dirt/dust,
/turf/open/floor/plasteel/techmaint,
/area/space)
"Ba" = (
/obj/effect/turf_decal/tile/neutral/tile_full,
/obj/effect/turf_decal/box,
/obj/effect/turf_decal/arrows{
	dir = 8
	},
/obj/effect/decal/cleanable/dirt,
/turf/open/floor/plasteel/techmaint,
/area/space)
"Bc" = (
/obj/effect/turf_decal/bot_white,
/obj/effect/decal/cleanable/cobweb/cobweb2,
/turf/open/floor/mineral/plastitanium,
/area/space)
"Cb" = (
/obj/effect/turf_decal/stripes/line,
/obj/effect/turf_decal/tile/neutral/tile_side{
	dir = 4
	},
/obj/structure/table/reinforced,
/obj/item/stack/sheet/mineral/plastitanium{
	amount = 30
	},
/obj/item/stack/cable_coil/red,
/obj/item/assembly/prox_sensor{
	desc = "Used for scanning and alerting when someone enters a certain proximity. This one is slightly shifted to the left.";
	pixel_x = -6;
	pixel_y = 6
	},
/obj/item/assembly/flash/handheld,
/obj/item/storage/belt/utility{
	pixel_y = -3
	},
/turf/open/floor/plasteel/techmaint,
/area/space)
"Co" = (
/obj/structure/dresser,
/obj/effect/decal/cleanable/cobweb,
/turf/open/floor/mineral/plastitanium,
/area/space)
"CD" = (
/obj/effect/turf_decal/trimline/brown/filled/line,
/obj/effect/turf_decal/trimline/brown/filled/line,
/obj/effect/turf_decal/trimline/brown/filled/line,
/obj/effect/turf_decal/tile/neutral/tile_side{
	dir = 4
	},
/obj/effect/decal/cleanable/dirt,
/obj/machinery/light,
/turf/open/floor/plasteel/techmaint,
/area/space)
"CG" = (
/obj/effect/turf_decal/trimline/brown/filled/line{
	dir = 1
	},
/obj/effect/turf_decal/trimline/brown/filled/line{
	dir = 1
	},
/obj/effect/turf_decal/trimline/brown/filled/line{
	dir = 1
	},
/obj/effect/turf_decal/tile/neutral/tile_side{
	dir = 8
	},
/obj/effect/decal/cleanable/dirt/dust,
/turf/open/floor/plasteel/techmaint,
/area/space)
"CP" = (
/turf/closed/wall/r_wall/syndicate/nodiagonal,
/area/space)
"CW" = (
/obj/effect/turf_decal/tile/neutral/tile_full,
/obj/effect/turf_decal/box,
/obj/effect/turf_decal/arrows{
	dir = 8
	},
/obj/effect/decal/cleanable/dirt,
/obj/effect/decal/cleanable/dirt/dust,
/obj/structure/closet/crate,
/turf/open/floor/plasteel/techmaint,
/area/space)
"DH" = (
/obj/effect/turf_decal/tile/neutral/tile_full,
/obj/effect/decal/cleanable/dirt/dust,
/turf/open/floor/plasteel/techmaint,
/area/space)
"Ex" = (
/obj/effect/turf_decal/tile/neutral/tile_full,
/obj/effect/turf_decal/box,
/obj/effect/turf_decal/arrows{
	dir = 8
	},
/turf/open/floor/plasteel/techmaint,
/area/space)
"EY" = (
/obj/structure/shuttle/engine/heater,
/obj/structure/window/reinforced/survival_pod{
	dir = 1
	},
/obj/structure/window/plastitanium,
/turf/open/floor/plating,
/area/space)
"Fl" = (
/obj/effect/turf_decal/tile/neutral/tile_full,
/obj/effect/turf_decal/box,
/obj/effect/turf_decal/arrows{
	dir = 8
	},
/obj/effect/decal/cleanable/dirt,
/obj/effect/decal/cleanable/dirt/dust,
/obj/effect/decal/cleanable/dirt/dust,
/turf/open/floor/plasteel/techmaint,
/area/space)
"Fn" = (
/obj/effect/decal/cleanable/ash{
	pixel_x = 15;
	pixel_y = 12
	},
/turf/open/floor/mineral/plastitanium,
/area/space)
"Fo" = (
/obj/effect/turf_decal/stripes/line{
	dir = 10
	},
/obj/effect/turf_decal/tile/neutral/tile_full,
/obj/machinery/computer/monitor/secret{
	dir = 4
	},
/turf/open/floor/mineral/plastitanium,
/area/space)
"Fs" = (
/obj/effect/turf_decal/trimline/brown/filled/line{
	dir = 9
	},
/obj/effect/turf_decal/trimline/brown/filled/line{
	dir = 9
	},
/obj/effect/turf_decal/trimline/brown/filled/line{
	dir = 9
	},
/obj/effect/turf_decal/tile/neutral,
/obj/effect/decal/cleanable/dirt/dust,
/obj/structure/closet/crate/bin{
	pixel_y = 10
	},
/obj/item/trash/pistachios,
/obj/item/trash/syndi_cakes,
/obj/item/trash/waffles,
/turf/open/floor/plasteel/techmaint,
/area/space)
"Fu" = (
/obj/effect/turf_decal/stripes/line,
/obj/effect/turf_decal/stripes/corner{
	dir = 4
	},
/obj/effect/turf_decal/tile/neutral/tile_full,
/turf/open/floor/mineral/plastitanium,
/area/space)
"FB" = (
/obj/effect/turf_decal/stripes/line,
/obj/effect/turf_decal/stripes/corner{
	dir = 1
	},
/obj/effect/turf_decal/tile/neutral/tile_full,
/turf/open/floor/pod/dark,
/area/space)
"FS" = (
/obj/machinery/porta_turret/syndicate/pod{
	dir = 4
	},
/turf/closed/wall/r_wall/syndicate,
/area/space)
"Gc" = (
/obj/effect/turf_decal/tile/neutral/tile_full,
/obj/effect/turf_decal/box,
/obj/effect/turf_decal/arrows{
	dir = 4;
	icon_state = "arrows"
	},
/turf/open/floor/plasteel/techmaint,
/area/space)
"Gi" = (
/obj/effect/turf_decal/trimline/brown/filled/corner{
	dir = 4
	},
/obj/effect/turf_decal/trimline/brown/filled/corner{
	dir = 4
	},
/obj/effect/turf_decal/trimline/brown/filled/corner{
	dir = 4
	},
/obj/effect/turf_decal/tile/neutral/tile_side{
	dir = 5
	},
/obj/effect/decal/cleanable/dirt,
/obj/effect/decal/cleanable/dirt,
/turf/open/floor/plasteel/techmaint,
/area/space)
"GB" = (
/obj/effect/turf_decal/tile/neutral/tile_full,
/turf/open/floor/plasteel/techmaint,
/area/space)
"Hy" = (
/obj/structure/mirror{
	pixel_y = 28
	},
/turf/open/floor/plasteel/showroomfloor,
/area/space)
"HE" = (
/obj/structure/bed/pod,
/obj/item/bedsheet/black,
/obj/machinery/light{
	dir = 1
	},
/obj/structure/sign/poster/contraband/random{
	pixel_y = 32
	},
/turf/open/floor/mineral/plastitanium,
/area/space)
"Ih" = (
/obj/effect/turf_decal/stripes/line,
/obj/effect/turf_decal/tile/neutral/tile_side{
	dir = 4
	},
/obj/structure/reagent_dispensers/watertank,
/obj/effect/turf_decal/delivery,
/turf/open/floor/plasteel/techmaint,
/area/space)
"Iu" = (
/obj/machinery/door/airlock/hatch,
/turf/open/floor/plasteel/showroomfloor,
/area/space)
"II" = (
/obj/effect/turf_decal/trimline/brown/filled/line{
	dir = 10
	},
/obj/effect/turf_decal/trimline/brown/filled/line{
	dir = 10
	},
/obj/effect/turf_decal/trimline/brown/filled/line{
	dir = 10
	},
/obj/effect/turf_decal/tile/neutral{
	dir = 4
	},
/turf/open/floor/plasteel/techmaint,
/area/space)
"Jz" = (
/obj/effect/turf_decal/stripes/closeup,
/obj/machinery/door/airlock/hatch,
/obj/machinery/door/firedoor,
/turf/open/floor/mineral/plastitanium/red,
/area/space)
"JF" = (
/obj/structure/shuttle/engine/propulsion,
/turf/open/floor/plating,
/area/space)
"JO" = (
/obj/effect/turf_decal/tile/neutral/tile_full,
/obj/effect/turf_decal/box,
/obj/effect/turf_decal/arrows{
	dir = 4;
	icon_state = "arrows"
	},
/obj/effect/decal/cleanable/dirt/dust,
/obj/structure/closet/crate,
/turf/open/floor/plasteel/techmaint,
/area/space)
"Kb" = (
/obj/effect/turf_decal/stripes/line{
	dir = 9
	},
/obj/effect/turf_decal/tile/neutral,
/obj/machinery/suit_storage_unit/syndicate,
/obj/effect/turf_decal/bot,
/obj/machinery/light{
	dir = 8
	},
/turf/open/floor/plasteel/techmaint,
/area/space)
"Ld" = (
/obj/effect/turf_decal/tile/neutral/tile_full,
/obj/effect/turf_decal/box,
/obj/effect/turf_decal/arrows{
	dir = 8
	},
/obj/structure/closet/crate/large,
/turf/open/floor/plasteel/techmaint,
/area/space)
"Lo" = (
/turf/open/space/basic,
/area/space)
"LU" = (
/obj/effect/turf_decal/stripes/red/line{
	dir = 8;
	icon_state = "warningline_red"
	},
/turf/open/floor/mineral/plastitanium,
/area/space)
"Mb" = (
/obj/effect/turf_decal/stripes/corner{
	dir = 1
	},
/obj/effect/turf_decal/tile/neutral/tile_full,
/obj/structure/chair/comfy/shuttle{
	dir = 1
	},
/turf/open/floor/mineral/plastitanium,
/area/space)
"Mq" = (
/obj/effect/turf_decal/bot_white,
/obj/effect/turf_decal/stripes/line{
	dir = 8
	},
/obj/machinery/light{
	dir = 4
	},
/turf/open/floor/mineral/plastitanium,
/area/space)
"Nc" = (
/obj/effect/turf_decal/tile/neutral/tile_full,
/obj/effect/turf_decal/box,
/obj/effect/turf_decal/arrows{
	dir = 4;
	icon_state = "arrows"
	},
/obj/structure/closet/crate/freezer,
/turf/open/floor/plasteel/techmaint,
/area/space)
"Nq" = (
/obj/effect/turf_decal/tile/neutral/tile_full,
/obj/effect/turf_decal/box,
/obj/effect/turf_decal/arrows{
	dir = 8
	},
/obj/effect/decal/cleanable/dirt,
/obj/effect/decal/cleanable/dirt/dust,
/turf/open/floor/plasteel/techmaint,
/area/space)
"NJ" = (
/obj/effect/turf_decal/stripes/line{
	dir = 9
	},
/obj/effect/turf_decal/tile/neutral/tile_full,
/obj/machinery/light{
	dir = 8
	},
/obj/machinery/computer/shuttle_flight/syndicate,
/turf/open/floor/mineral/plastitanium,
/area/space)
"NN" = (
/obj/effect/turf_decal/stripes/line,
/obj/effect/turf_decal/tile/neutral/tile_full,
/obj/structure/table/reinforced,
/obj/item/toy/figure/syndie{
	pixel_x = -8;
	pixel_y = -7
	},
/obj/item/paper_bin{
	pixel_x = 5;
	pixel_y = 4
	},
/obj/item/pen{
	pixel_x = 5;
	pixel_y = 6
	},
/turf/open/floor/mineral/plastitanium,
/area/space)
"Oa" = (
/obj/effect/turf_decal/trimline/brown/filled/line,
/obj/effect/turf_decal/trimline/brown/filled/line,
/obj/effect/turf_decal/trimline/brown/filled/line,
/obj/effect/turf_decal/tile/neutral/tile_side{
	dir = 4
	},
/obj/machinery/light,
/turf/open/floor/plasteel/techmaint,
/area/space)
"Ob" = (
/obj/structure/shuttle/engine/large,
/turf/open/floor/plating,
/area/space)
"Oe" = (
/obj/effect/turf_decal/trimline/brown/filled/line,
/obj/effect/turf_decal/trimline/brown/filled/line,
/obj/effect/turf_decal/trimline/brown/filled/line,
/obj/effect/turf_decal/tile/neutral/tile_side{
	dir = 4
	},
/obj/effect/decal/cleanable/dirt,
/obj/effect/decal/cleanable/dirt/dust,
/turf/open/floor/plasteel/techmaint,
/area/space)
"On" = (
/obj/effect/turf_decal/tile/neutral/tile_side{
	dir = 10
	},
/obj/effect/turf_decal/stripes/corner,
/obj/structure/chair/office{
	dir = 4;
	name = "tactical swivel chair"
	},
/turf/open/floor/plasteel/techmaint,
/area/space)
"Ou" = (
/obj/effect/turf_decal/tile/neutral/tile_full,
/obj/effect/turf_decal/box,
/obj/effect/turf_decal/arrows{
	dir = 4;
	icon_state = "arrows"
	},
/obj/structure/closet/crate/engineering,
/turf/open/floor/plasteel/techmaint,
/area/space)
"OM" = (
/obj/effect/turf_decal/trimline/brown/filled/line{
	dir = 8
	},
/obj/effect/turf_decal/trimline/brown/filled/line{
	dir = 8
	},
/obj/effect/turf_decal/trimline/brown/filled/line{
	dir = 8
	},
/obj/effect/turf_decal/tile/neutral/tile_side,
/obj/effect/decal/cleanable/dirt,
/obj/machinery/light{
	dir = 8
	},
/turf/open/floor/plasteel/techmaint,
/area/space)
"OW" = (
/obj/effect/turf_decal/trimline/brown/filled/line{
	dir = 1
	},
/obj/effect/turf_decal/trimline/brown/filled/line{
	dir = 1
	},
/obj/effect/turf_decal/trimline/brown/filled/line{
	dir = 1
	},
/obj/effect/turf_decal/tile/neutral/tile_side{
	dir = 8
	},
/obj/effect/decal/cleanable/dirt/dust,
/obj/machinery/light{
	dir = 1
	},
/turf/open/floor/plasteel/techmaint,
/area/space)
"OX" = (
/obj/effect/turf_decal/trimline/brown/filled/line{
	dir = 5
	},
/obj/effect/turf_decal/trimline/brown/filled/line{
	dir = 5
	},
/obj/effect/turf_decal/trimline/brown/filled/line{
	dir = 5
	},
/obj/effect/turf_decal/tile/neutral{
	dir = 8
	},
/obj/structure/closet/cardboard,
/turf/open/floor/plasteel/techmaint,
/area/space)
"Pj" = (
/obj/effect/turf_decal/stripes/end{
	dir = 1
	},
/obj/effect/turf_decal/tile/neutral/tile_full,
/obj/structure/table,
/obj/machinery/microwave{
	pixel_y = 5
	},
/obj/item/storage/box/donkpockets/donkpocketteriyaki{
	pixel_x = 4;
	pixel_y = 5
	},
/obj/item/storage/box/donkpockets/donkpocketteriyaki,
/obj/effect/decal/cleanable/food/flour{
	pixel_y = -7
	},
/turf/open/floor/pod,
/area/space)
"Ps" = (
/obj/effect/turf_decal/stripes/line{
	dir = 9
	},
/obj/effect/turf_decal/tile/neutral/tile_full,
/obj/machinery/light{
	dir = 1
	},
/obj/machinery/computer/camera_advanced/syndie{
	dir = 4
	},
/turf/open/floor/mineral/plastitanium,
/area/space)
"Pt" = (
/obj/effect/turf_decal/trimline/brown/filled/line{
	dir = 4
	},
/obj/effect/turf_decal/trimline/brown/filled/line{
	dir = 4
	},
/obj/effect/turf_decal/trimline/brown/filled/line{
	dir = 4
	},
/obj/effect/turf_decal/tile/neutral/tile_side{
	dir = 1
	},
/obj/effect/decal/cleanable/dirt,
/obj/machinery/light{
	dir = 4
	},
/obj/machinery/button/door{
	id = "syndiecargo_entranceshutters";
	name = "cargohold shutters";
	pixel_x = 28
	},
/turf/open/floor/plasteel/techmaint,
/area/space)
"PY" = (
/obj/effect/turf_decal/stripes/line{
	dir = 1
	},
/obj/effect/turf_decal/tile/neutral/tile_side{
	dir = 8
	},
/obj/machinery/power/apc/auto_name/north,
/obj/structure/cable{
	icon_state = "0-2"
	},
/turf/open/floor/plasteel/techmaint,
/area/space)
"PZ" = (
/obj/effect/turf_decal/tile/neutral/tile_full,
/obj/effect/turf_decal/box,
/obj/effect/turf_decal/arrows{
	dir = 4;
	icon_state = "arrows"
	},
/obj/effect/decal/cleanable/dirt/dust,
/turf/open/floor/plasteel/techmaint,
/area/space)
"Qj" = (
/obj/effect/turf_decal/trimline/brown/filled/line{
	dir = 1
	},
/obj/effect/turf_decal/trimline/brown/filled/line{
	dir = 1
	},
/obj/effect/turf_decal/trimline/brown/filled/line{
	dir = 1
	},
/obj/effect/turf_decal/tile/neutral/tile_side{
	dir = 8
	},
/turf/open/floor/plasteel/techmaint,
/area/space)
"QQ" = (
/obj/structure/toilet{
	dir = 8;
	icon_state = "toilet00"
	},
/obj/structure/sink{
	pixel_y = 24
	},
/obj/machinery/light/small,
/turf/open/floor/plasteel/showroomfloor,
/area/space)
"Rm" = (
/obj/effect/turf_decal/trimline/brown/filled/warning{
	dir = 4
	},
/obj/effect/turf_decal/trimline/brown/filled/warning{
	dir = 4
	},
/obj/effect/turf_decal/trimline/brown/filled/warning{
	dir = 4
	},
/obj/effect/turf_decal/tile/neutral/tile_side{
	dir = 1
	},
/obj/effect/turf_decal/loading_area{
	dir = 4
	},
/obj/effect/decal/cleanable/dirt,
/obj/effect/decal/cleanable/dirt,
/obj/effect/decal/cleanable/dirt/dust,
/turf/open/floor/plasteel/techmaint,
/area/space)
"RB" = (
/obj/effect/turf_decal/stripes/line{
	dir = 8
	},
/turf/open/floor/plasteel/tech/grid,
/area/space)
"RX" = (
/obj/effect/turf_decal/tile/neutral/tile_full,
/obj/effect/turf_decal/box,
/obj/effect/turf_decal/arrows{
	dir = 8
	},
/obj/structure/closet/crate/medical,
/turf/open/floor/plasteel/techmaint,
/area/space)
"Si" = (
/obj/effect/turf_decal/tile/neutral/tile_side{
	dir = 6
	},
/obj/effect/turf_decal/stripes/corner{
	dir = 8
	},
/turf/open/floor/plasteel/techmaint,
/area/space)
"St" = (
/obj/effect/turf_decal/trimline/brown/filled/line{
	dir = 9
	},
/obj/effect/turf_decal/trimline/brown/filled/line{
	dir = 9
	},
/obj/effect/turf_decal/trimline/brown/filled/line{
	dir = 9
	},
/obj/effect/turf_decal/tile/neutral,
/obj/structure/sign/poster/contraband/random{
	pixel_x = -32
	},
/turf/open/floor/plasteel/techmaint,
/area/space)
"SZ" = (
/obj/effect/turf_decal/trimline/brown/filled/warning,
/obj/effect/turf_decal/trimline/brown/filled/warning,
/obj/effect/turf_decal/trimline/brown/filled/warning,
/obj/effect/turf_decal/tile/neutral/tile_side{
	dir = 4
	},
/obj/effect/decal/cleanable/dirt,
/obj/effect/decal/cleanable/dirt/dust,
/turf/open/floor/plasteel/techmaint,
/area/space)
"Te" = (
/turf/closed/wall/r_wall/syndicate,
/area/space)
"Ti" = (
/obj/effect/turf_decal/stripes/line{
	dir = 4
	},
/obj/effect/turf_decal/tile/neutral/tile_full,
/mob/living/simple_animal/hostile/syndicate/melee,
/obj/machinery/button/door{
	id = "syndieshutters_small_cargo";
	name = "Window shutters";
	pixel_x = 28
	},
/turf/open/floor/mineral/plastitanium,
/area/space)
"TB" = (
/obj/effect/turf_decal/tile/neutral/tile_full,
/obj/effect/decal/cleanable/dirt,
/turf/open/floor/plasteel/techmaint,
/area/space)
"Vv" = (
/obj/effect/turf_decal/stripes/line{
	dir = 8
	},
/obj/effect/turf_decal/stripes/corner{
	dir = 4
	},
/obj/effect/turf_decal/tile/neutral/tile_full,
/obj/machinery/light{
	dir = 8
	},
/turf/open/floor/pod/dark,
/area/space)
"VB" = (
/obj/machinery/door/poddoor/shutters{
	id = "syndieshutters_small_cargo";
	name = "blast shutters"
	},
/obj/structure/grille,
/obj/structure/window/plastitanium,
/turf/open/floor/plating,
/area/space)
"Wq" = (
/obj/effect/turf_decal/stripes/line{
	dir = 1
	},
/obj/effect/turf_decal/tile/neutral/tile_side{
	dir = 8
	},
/turf/open/floor/plasteel/techmaint,
/area/space)
"Wr" = (
/obj/machinery/door/poddoor{
	id = "syndiecargo_entranceshutters";
	name = "Cargo hold"
	},
/obj/effect/turf_decal/stripes/line{
	dir = 4
	},
/obj/structure/fans/tiny,
/turf/open/floor/plasteel/tech/grid,
/area/space)
"WY" = (
/obj/effect/turf_decal/tile/neutral/tile_full,
/obj/effect/turf_decal/box,
/obj/effect/turf_decal/arrows{
	dir = 4;
	icon_state = "arrows"
	},
/obj/effect/decal/cleanable/dirt/dust,
/obj/effect/decal/cleanable/dirt/dust,
/obj/structure/closet/crate/freezer,
/turf/open/floor/plasteel/techmaint,
/area/space)
"XH" = (
/obj/effect/turf_decal/tile/neutral/tile_full,
/obj/effect/decal/cleanable/oil,
/turf/open/floor/plasteel/techmaint,
/area/space)
"YZ" = (
/obj/effect/turf_decal/stripes/line{
	dir = 1
	},
/obj/effect/turf_decal/tile/neutral/tile_side{
	dir = 8
	},
/obj/structure/closet/toolcloset,
/obj/effect/turf_decal/box,
/turf/open/floor/plasteel/techmaint,
/area/space)
"Zr" = (
/obj/effect/turf_decal/stripes/line{
	dir = 5
	},
/obj/effect/turf_decal/tile/neutral/tile_full,
/obj/item/reagent_containers/food/drinks/syndicatebeer{
	pixel_x = -8;
	pixel_y = 2
	},
/obj/item/toy/cards/deck/syndicate{
	pixel_x = -4
	},
/obj/item/storage/fancy/cigarettes/cigpack_syndicate{
	pixel_x = 11;
	pixel_y = 6
	},
/obj/item/lighter/greyscale{
	pixel_x = 11;
	pixel_y = -2
	},
/obj/machinery/computer/security/telescreen/entertainment{
	pixel_y = 28
	},
/obj/structure/table/reinforced,
/turf/open/floor/pod/dark,
/area/space)

(1,1,1) = {"
Lo
Te
VB
VB
Te
Lo
Lo
Lo
Lo
oL
Te
Te
Wr
Wr
Wr
Te
Te
mG
Te
Te
Te
Lo
Lo
Lo
"}
(2,1,1) = {"
oL
CP
Ps
Fo
CP
Te
VB
Te
Te
CP
St
fG
iQ
iQ
uR
OM
II
Te
Kb
kD
CP
Te
Lo
Lo
"}
(3,1,1) = {"
VB
NJ
Mb
NN
CP
Co
iL
Fn
CP
Fs
gr
WY
PZ
rt
PZ
hh
he
Te
Wq
Si
hZ
Te
Te
jr
"}
(4,1,1) = {"
VB
Al
Ti
Fu
CP
HE
iL
iL
CP
OW
sY
sY
TB
TB
GB
DH
Oa
Te
Wq
GB
Ih
EY
mg
Ob
"}
(5,1,1) = {"
Te
CP
CP
Jz
CP
iL
iL
iL
CP
Qj
GB
Gc
Nc
JO
Gc
Ou
Oe
Te
Wq
XH
wC
EY
mg
mg
"}
(6,1,1) = {"
Lo
Lo
Lo
Lo
Lo
iL
iL
iL
CP
Lo
Lo
Lo
Lo
Lo
Lo
Lo
Lo
Lo
Lo
Lo
Lo
Lo
Lo
Lo
"}
(7,1,1) = {"
Lo
Lo
Lo
Lo
Lo
Lo
iL
iL
Lo
Lo
Lo
Lo
Lo
Lo
Lo
Lo
Lo
Lo
Lo
Lo
Lo
Lo
Lo
Lo
"}
(8,1,1) = {"
Te
Hy
Iu
yx
qV
qV
iL
nO
CP
AR
TB
GB
GB
sY
GB
DH
SZ
hS
wj
GB
kW
EY
JF
Lo
"}
(9,1,1) = {"
Te
QQ
CP
aV
CP
CP
iL
iL
CP
CG
GB
Ex
Ld
Ex
Fl
CW
sJ
Te
PY
ok
wQ
EY
mg
Ob
"}
(10,1,1) = {"
Te
CP
CP
Jz
CP
qy
iL
LU
CP
xs
TB
GB
DH
GB
GB
TB
CD
Te
sq
GB
Cb
EY
mg
mg
"}
(11,1,1) = {"
Te
Pj
Vv
FB
CP
Bc
iL
Mq
CP
OX
Gi
Ba
Nq
Ex
RX
Ex
Oe
Te
YZ
On
rU
Te
Te
jg
"}
(12,1,1) = {"
kC
Te
Zr
fw
Te
Te
Lo
Te
Te
CP
zr
Pt
tJ
Rm
tk
sb
mS
Te
vx
gG
CP
Te
Lo
Lo
"}
(13,1,1) = {"
Lo
Te
Te
Te
Te
Lo
Lo
Lo
Lo
kC
Te
Te
RB
RB
RB
Te
Te
FS
Te
Te
Te
Lo
Lo
Lo
"}
